10 10 10 10 10 10 10 10 10 10 10 10 10 10 10 10 10 10 10 10 10 10 10 10
10 10 10 10 10 10 10 10 10 10 10 10 10 10 10 10 10 10 10 10 10 10 10 10
10 10 00 00 00 00 00 00 00 00 00 00 00 08 08 08 08 00 00 00 00 10 10 10
10 10 00 00 00 00 00 00 00 00 00 00 00 08 08 12 08 00 00 00 00 00 10 10
10 10 00 00 00 00 00 00 00 00 00 00 00 00 00 00 00 00 00 00 00 00 10 10
10 10 00 00 00 00 00 00 00 00 00 00 00 00 00 00 00 00 00 00 00 00 10 10
10 10 00 00 00 00 00 00 00 00 00 00 00 00 00 00 00 00 00 00 00 00 10 10
10 10 00 00 00 00 00 00 00 00 00 00 00 00 00 00 00 00 00 00 00 00 10 10
10 10 00 00 00 00 00 00 00 00 00 00 00 00 00 00 00 00 00 00 00 10 10 10
10 10 00 00 00 00 00 00 00 00 00 00 00 00 00 00 00 00 00 00 00 10 10 10
10 10 00 00 00 00 00 00 00 00 00 00 00 00 00 00 00 00 00 00 00 00 10 10
10 10 00 00 00 00 00 00 00 00 00 00 00 00 00 00 00 00 00 00 00 00 10 10
10 10 10 10 10 10 10 10 10 10 10 10 10 10 10 10 10 10 10 10 10 10 10 10
10 10 10 10 10 10 10 10 10 10 10 10 10 10 10 10 10 10 10 10 10 10 10 10